0 0 0 0 0 0 0 0 0 0 0 0 0 0 0 
0 1 1 1 1 1 1 1 1 1 1 1 1 1 1 
0 0 0 0 0 1 0 1 0 1 0 0 0 0 0 
0 1 1 1 0 1 0 1 0 1 0 1 1 1 0 
0 1 0 1 0 1 0 1 0 1 0 1 0 1 0 
0 1 0 1 1 1 0 1 0 1 1 1 0 1 0 
0 1 0 1 0 0 0 1 0 0 0 1 0 1 0 
0 0 0 1 1 1 1 1 1 1 1 1 0 0 0 
0 1 0 1 0 0 0 0 0 0 0 1 0 1 0 
0 1 0 1 1 1 1 0 1 1 1 1 0 1 0 
0 1 0 1 0 0 0 0 0 0 0 1 0 1 0 
0 1 1 1 1 1 1 1 1 1 1 1 1 1 0 
0 0 0 0 0 0 0 1 0 0 0 0 0 0 0 
1 1 1 1 1 1 1 1 1 1 1 1 1 1 0 
0 0 0 0 0 0 0 0 0 0 0 0 0 0 0 
13 0, 13 1, 13 2, 13 3, 13 4, 13 5, 13 6, 13 7, 12 7, 11 7, 11 6, 11 5, 11 4, 11 3, 10 3, 9 3, 8 3, 7 3, 6 3, 5 3, 5 4, 5 5, 4 5, 3 5, 2 5, 1 5, 1 6, 1 7, 1 8, 1 9, 1 10, 1 11, 1 12, 1 13, 1 14